0405003B3010005
080100337004001
000100373008000
0A0600733010600
B937333B333A3B3
B7BB73793336733
009800367000900
040000333001000
080000733000005
000500333000001