0400003B3000005
080000337004001
000100333008000
000000733000000
3337333B33333B3
B33333733333733
000800337000000
040000333001000
080000733000005
000500333000001