01030040123A010
504988880400200
0079B9900003030
000888888880000
000099990000000
000099990000000
000009999000000
000888888000000
000000009999000
000000000999900