01030040123A010
504999A00400200
0079B9900003030
000999900000000
000099990000000
000099990000000
000009999000000
000000000000000
000000009999000
000000000999900